Красный цвет кричит "ДА-ДА-ДА!"
Оранжевый шепчет "может быть..."
Жёлтый машет лапкой: "Нет-нет-нет!"
Зелёный задумался... и заснул
Голубой пускает пузыри: "Да!"
Синий нахмурился: "Ни за что!"
Фиолетовый колдует: "Спроси снова!"
Розовый единорог прошептал "Да!"
Серебряный звонок звонит: "Нет!"
Золотой дракон рычит: "Может быть!"
Радуга переливается: "Да-нет-да!"
Чёрная кошка пробежала: "Нет!"
Белое облако напевает: "Да..."
Серый волчок крутится: "Не знаю!"
Разноцветный попугай: "Конечно да!"
Изумрудный листик шепчет: "Нет..."
Коричневый мишка: "Может быть!"
Бирюзовый ручей: "Да, если искупаешься!"
Лиловый закат: "Нет, уже поздно!"
Малиновый мармелад: "Да-да-да!"
Оливковая ветвь: "Нет, нужно подумать"
Лазоревый экран: "Ошибка 404!"
Перламутровая ракушка: "Ш-ш-ш... да..."
Багровый закат: "Нет, время вышло!"
Неоновый знак: "ДА БЕЗ ВОПРОСОВ!"
Пастельный зайчик: "Может быть..."
Хаки-хамелеон: "Нет, я спрятался!"
Фуксия фея: "Да с волшебной пылью!"
Терракотовый горшок: "Нет, я пустой!"
Аквамарин волна: "Да, если нырнёшь!"
Ультрамарин космос: "Нет, слишком далеко!"
Пудровая пантера: "Может быть ночью..."
Мятный дракончик: "Да с прохладой!"
Шоколадный фонтан: "Нет, слишком сладко!"
Рыжий лис: "Да, если догонишь!"
Фисташковый попугай: "Нет, я на диете!"
Ванильное облако: "Да с ароматом!"
Графитовая туча: "Нет, будет дождь!"
Медовый месяц: "Да с привкусом!"
Чернильная ночь: "Нет, уже спать!"
Сапфировый взгляд: "Да, если увидишь!"
Рубиновые губы: "Нет, это секрет!"
Изумрудный лес: "Да, если найдёшь!"
Аметистовый сон: "Нет, не буди!"
Бронзовый герой: "Да, если спасёшь!"
Жемчужная нить: "Нет, порвалась!"
Лимонный смех: "Да с кислинкой!"
Сливовый джем: "Нет, слишком сладко!"
Коралловый риф: "Да, если нырнёшь!"
Облачный пух: "Нет, улетел!"